9x8
*********
*^*****%*
*.......*
*.......*
*.......*
*.......*
*.......*
*********