15x15
***************
*^......*.....*
***.*.*.*.*****
*...*.*.*.....*
*.*.*****.*.***
*.*.......*...*
*.***.*********
*.*...*...*...*
***.*.*.*...***
*...*...*...***
*.*.*.***.*.***
*.*.*.*...*...*
*.*.***.*.***.*
*.*.*...*.***%*
***************
