7x7
*******
*^....*
*****.*
*.....*
*.*****
*....%*
*******