15x15
***************
*^........*...*
*.........*...*
*.........*...*
*..*......*...*
*..*..........*
*..*..........*
*..*....*...***
*..*....*...***
*.......*.....*
*.......*.....*
*...*...*.....*
*...*.........*
*...*........%*
***************