15x15
***************
*^......*.....*
***.*.*.*.*****
*...*.*.*.....*
*.*.*****.*.***
*.*.......*...*
*.***.*********
*.*...*...*...*
***.*.*.*.*.*.*
*...*...*...*.*
*.*.*.***.%.***
*.*.*.*.......*
*.*.***.*.***.*
*.*.*...*.....*
***************
