7x6
*******
*^***%*
*.....*
*.....*
*.....*
*******