7x7
*******
*^....*
*.....*
*.....*
*.....*
*....%*
*******