10x10
**********
*^.......*
*........*
*........*
*........*
*........*
*........*
*........*
*.......%*
**********