10x10
**********
*^.****..*
*..****..*
*..****..*
*..****..*
*..****..*
*........*
*........*
*........*
*..****..*
*..****..*
*..****..*
*..****..*
*..****.%*
**********