7x6
*******
*^.*.%*
*..*..*
*..*..*
*.....*
*******